10 10 10 10 10 10 10 10 10 10 10 10 10 10 10 10 10 10 10 10 10 10 10 10 10 10 10 10
10 10 10 10 10 10 10 10 10 10 10 10 10 10 10 10 10 10 10 10 10 10 10 10 10 10 10 10
10 10 10 10 10 10 10 10 10 10 10 10 10 10 10 10 10 10 10 10 10 10 10 10 10 10 10 10
10 10 10 10 10 10 10 10 10 10 10 10 10 10 10 10 10 10 10 10 10 10 10 10 10 10 10 10
10 10 10 10 10 10 10 10 10 10 10 10 10 10 10 10 10 10 10 10 10 10 10 10 10 10 10 10
10 10 10 10 10 10 10 10 10 10 10 10 10 10 10 10 10 10 10 10 10 10 10 10 10 10 10 10
10 10 10 10 10 10 10 10 10 10 10 10 10 10 10 10 10 10 10 10 10 10 10 10 10 10 10 10
10 10 10 10 10 10 10 10 10 10 10 10 10 10 10 10 10 10 10 10 10 10 10 10 10 10 10 10
10 10 10 10 10 10 10 10 10 10 10 10 10 10 10 10 10 10 10 10 10 10 10 10 10 10 10 10
10 10 10 10 10 10 10 10 10 10 10 10 10 10 10 10 10 10 10 10 10 10 10 10 10 10 10 10
10 10 10 10 10 10 10 10 10 10 10 10 10 10 10 10 10 10 10 10 10 10 10 10 10 10 10 10
10 10 10 10 10 10 10 10 10 10 10 10 10 10 10 10 10 10 10 10 10 10 10 10 10 10 10 10
10 10 10 10 10 10 10 10 10 10 10 10 10 10 10 10 10 10 10 10 10 10 10 10 10 10 10 10
10 10 10 10 10 10 10 10 10 10 10 10 10 10 10 10 10 10 10 10 10 10 10 10 10 10 10 10
10 10 10 10 10 10 10 10 10 10 10 10 10 10 10 10 10 10 10 10 10 10 10 10 10 10 10 10
10 10 10 10 10 10 10 10 10 10 10 10 10 10 10 10 10 10 10 10 10 10 10 10 10 10 10 10
10 10 10 10 10 10 10 10 10 10 10 10 10 10 10 10 10 10 10 10 10 10 10 10 10 10 10 10
10 10 10 10 10 10 10 10 10 10 10 10 10 10 10 10 10 10 10 10 10 10 10 10 10 10 10 10
10 10 10 10 10 10 10 10 10 10 10 10 10 10 10 10 10 10 10 10 10 10 10 10 10 10 10 10
10 10 10 10 10 10 10 10 10 10 10 10 10 10 10 10 10 10 10 10 10 10 10 10 10 10 10 10
10 10 10 10 10 10 10 10 10 10 10 10 10 10 10 10 10 10 10 10 10 10 10 10 10 10 10 10
10 10 10 10 10 10 10 10 10 10 10 10 10 10 10 10 10 10 10 10 10 10 10 10 10 10 10 10
10 10 10 10 10 10 10 10 10 10 10 10 10 10 10 10 10 10 10 10 10 10 10 10 10 10 10 10
10 10 10 10 10 10 10 10 10 10 10 10 10 10 10 10 10 10 10 10 10 10 10 10 10 10 10 10
10 10 10 10 10 10 10 10 10 10 10 10 10 10 10 10 10 10 10 10 10 10 10 10 10 10 10 10
10 10 10 10 10 10 10 10 10 10 10 10 10 10 10 10 10 10 10 10 10 10 10 10 10 10 10 10
20 13 13 24 21 21 22 21 21 23 13 13 13 13 13 13 20 10 10 10 10 10 10 10 10 10 10 10
20 13 13 19 17 17 17 17 17 18 13 13 13 13 13 13 20 10 10 10 10 10 10 10 10 10 10 10
20 13 13 19 17 17 17 17 17 18 20 20 20 13 20 20 20 10 10 10 10 10 10 10 10 10 10 10
20 13 13 19 17 17 17 17 17 18 28 28 28 13 28 28 20 10 10 10 10 10 10 10 10 10 10 10
20 13 13 19 17 17 17 17 17 18 28 28 28 13 28 28 20 10 10 10 10 10 10 10 10 10 10 10
20 13 13 19 17 17 17 17 17 18 13 13 13 13 13 13 20 10 10 10 10 10 10 10 10 10 10 10
20 13 13 19 17 17 17 17 17 18 13 13 13 13 13 13 20 10 10 10 10 10 10 10 10 10 10 10
20 13 13 19 17 17 17 17 17 18 13 13 13 13 13 13 28 10 10 10 10 10 10 10 10 10 10 10
20 13 13 26 25 25 25 25 25 27 13 13 13 13 13 13 28 10 10 10 10 10 10 10 10 10 10 10
20 13 13 13 13 13 13 13 13 13 13 13 13 13 13 13 13 10 10 10 10 10 10 10 10 10 10 10
20 13 13 13 13 13 13 13 13 13 13 13 13 13 13 13 20 10 10 10 10 10 10 10 10 10 10 10
20 13 13 13 13 13 13 13 13 13 13 13 13 13 13 13 20 10 10 10 10 10 10 10 10 10 10 10
20 13 13 24 21 21 22 21 21 23 13 13 13 13 13 13 20 10 10 10 10 10 10 10 10 10 10 10
20 13 13 19 17 17 17 17 17 18 13 13 13 13 13 13 20 20 20 20 20 20 20 20 20 20 20 20
20 13 13 19 17 17 17 17 17 18 13 13 13 13 13 13 20 28 28 28 28 28 28 28 28 28 28 20
20 13 13 19 17 17 17 17 17 18 13 13 13 13 13 13 20 28 28 28 28 28 28 28 28 28 28 20
20 13 13 19 17 17 17 17 17 18 13 13 13 13 13 13 28 13 13 13 13 13 13 13 13 13 13 20
20 13 13 19 17 17 17 17 17 18 13 13 13 13 13 13 28 13 13 13 13 13 13 13 13 13 13 20
20 13 13 19 17 17 17 17 17 18 13 13 13 13 13 13 13 13 13 13 13 13 13 13 13 13 13 20
20 13 13 19 17 17 17 17 17 18 13 13 13 13 13 13 20 13 13 13 13 13 20 13 13 13 13 20
20 13 13 19 17 17 17 17 17 18 13 13 13 13 13 13 20 13 13 13 13 13 20 13 13 13 13 20
20 13 13 19 17 17 17 17 17 18 13 13 13 13 13 13 20 13 13 13 13 13 20 13 13 13 13 20
20 13 13 19 17 17 17 17 17 18 13 13 13 13 13 13 20 13 13 13 13 13 20 13 13 13 13 20
20 20 20 20 20 20 20 20 20 20 20 20 20 20 20 20 20 20 20 20 20 20 20 20 20 20 20 20
