2 2 4 2 2 2 2 2 2 2 2 2 2 2 2 8 8 8 8 8 8 8 8 8 8
2 4 4 6 1 1 1 1 1 1 1 1 1 1 5 1 5 5 5 5 0 0 0 0 8
2 4 4 6 1 1 1 1 1 1 1 1 1 1 1 1 1 5 5 5 0 0 0 0 2
2 4 4 6 1 1 1 1 2 2 2 2 2 2 2 2 2 2 2 2 2 2 2 2 2
2 4 4 6 1 1 1 1 2 5 0 0 0 0 0 0 0 0 0 0 0 0 0 0 2
2 4 4 6 1 1 1 1 2 5 0 0 0 0 0 0 0 0 0 0 0 0 0 0 2
2 4 4 6 1 1 1 1 2 5 0 0 0 0 0 0 0 0 0 0 0 0 3 0 2
2 4 4 6 1 1 1 1 1 5 5 0 0 0 0 0 0 0 0 0 3 0 0 0 2
2 4 4 6 1 1 1 1 2 5 5 0 0 0 0 0 0 0 3 0 0 0 3 0 2
2 4 4 6 1 1 1 1 2 5 5 5 5 0 0 0 0 0 0 0 3 0 0 0 2
2 4 4 6 1 1 1 1 2 5 5 5 5 5 5 5 0 0 0 0 0 0 3 0 2
2 4 4 6 1 1 1 1 2 2 2 2 2 2 2 2 2 2 2 2 2 2 2 2 2
2 4 4 6 1 1 1 1 2 5 5 5 5 5 5 5 5 5 5 5 5 5 5 5 2
2 4 4 6 1 1 1 1 2 5 5 5 5 5 5 5 5 5 5 0 5 5 5 5 2
2 4 4 6 1 1 1 1 2 5 5 5 5 5 5 5 5 5 0 0 5 5 5 5 2
2 4 4 6 1 1 1 1 1 5 5 5 5 5 5 5 5 0 0 3 0 0 5 5 2
2 4 4 6 1 1 1 1 2 5 5 5 5 5 5 5 5 5 0 0 0 5 5 5 2
2 4 4 6 1 1 1 1 2 5 5 5 5 5 5 5 5 5 5 0 5 5 5 5 2
2 4 4 6 1 1 1 1 2 5 5 5 5 5 5 5 5 5 5 5 5 5 5 5 2
2 4 4 6 1 1 1 1 2 2 2 2 2 2 2 2 2 2 2 2 2 2 2 2 2
2 4 4 6 1 1 1 1 2 1 1 1 1 1 1 1 1 1 1 1 1 1 1 1 2
2 4 4 6 1 1 1 1 2 1 1 1 1 1 1 1 1 1 1 1 1 1 1 1 2
2 4 4 6 1 1 1 1 2 1 1 1 1 1 1 1 1 1 1 1 1 1 1 1 2
2 4 4 6 1 1 1 1 1 1 1 1 1 1 1 1 1 2 1 1 1 1 1 1 2
2 4 4 6 1 1 1 1 2 1 1 1 1 1 1 1 1 2 1 1 1 1 1 1 2
2 4 4 6 1 1 1 1 2 1 1 1 1 1 1 1 1 2 1 1 1 1 1 1 2
2 4 4 6 1 1 1 1 2 1 1 1 1 5 1 1 1 2 1 1 1 1 1 1 2
2 4 4 6 1 1 1 1 2 1 1 1 5 5 5 1 1 2 1 1 1 1 3 1 2
2 4 4 6 1 1 1 1 2 1 1 1 1 5 1 1 1 2 1 1 1 1 1 1 2
2 2 4 2 2 2 2 2 2 2 2 2 2 2 2 2 2 2 2 2 2 2 2 2 2
