10 10 10 10 10 10 10 10 10 10 10 10 10 10 10 10 10 10 10 10 10 10 10 10 10 10 10 10
10 10 10 10 10 10 10 10 10 10 10 10 10 10 10 10 10 10 10 10 10 10 10 10 10 10 10 10
10 10 10 10 10 10 10 10 10 10 10 10 10 10 10 10 10 10 10 10 10 10 10 10 10 10 10 10
10 10 10 10 10 10 10 10 10 10 10 10 10 10 10 10 10 10 10 10 10 10 10 10 10 10 10 10
10 10 10 10 10 10 10 10 10 10 10 10 10 10 10 10 10 10 10 10 10 10 10 10 10 10 10 10
10 10 10 10 10 10 10 10 10 10 10 10 10 10 10 10 10 10 10 10 10 10 10 10 10 10 10 10
10 10 10 10 10 10 10 10 10 10 10 10 10 10 10 10 10 10 10 10 10 10 10 10 10 10 10 10
10 10 10 10 10 10 10 10 10 10 10 10 10 10 10 10 10 10 10 10 10 10 10 10 10 10 10 10
10 10 10 10 10 10 10 10 10 10 10 10 10 10 10 10 10 10 10 10 10 10 10 10 10 10 10 10
10 10 10 10 10 10 10 10 10 10 10 10 10 10 10 10 10 10 10 10 10 10 10 10 10 10 10 10
10 10 10 10 10 10 10 10 10 10 10 10 10 10 10 10 10 10 10 10 10 10 10 10 10 10 10 10
10 10 10 10 10 10 10 10 10 10 10 10 10 10 10 10 10 10 10 10 10 10 10 10 10 10 10 10
10 10 10 10 10 10 10 10 10 10 10 10 10 10 10 10 10 10 10 10 10 10 10 10 10 10 10 10
10 10 10 10 10 10 10 10 10 10 10 10 10 10 10 10 10 10 10 10 10 10 10 10 10 10 10 10
10 10 10 10 10 10 10 10 10 10 10 10 10 10 10 10 10 10 10 10 10 10 10 10 10 10 10 10
10 10 10 10 10 10 10 10 10 10 10 10 10 10 10 10 10 10 10 10 10 10 10 10 10 10 10 10
10 10 10 10 10 10 10 10 10 10 10 10 10 10 10 10 10 10 10 10 10 10 10 10 10 10 10 10
10 10 10 10 10 10 10 10 10 10 10 10 10 10 10 10 10 10 10 10 10 10 10 10 10 10 10 10
10 10 10 10 10 10 10 10 10 10 10 10 10 10 10 10 10 10 10 10 10 10 10 10 10 10 10 10
10 10 10 10 10 10 10 10 10 10 10 10 10 10 10 10 10 10 10 10 10 10 10 10 10 10 10 10
10 10 10 10 10 10 10 10 10 10 10 10 10 10 10 10 10 10 10 10 10 10 10 10 10 10 10 10
10 10 10 10 10 10 10 10 10 10 10 10 10 10 10 10 10 10 10 10 10 10 10 10 10 10 10 10
10 10 10 10 10 10 10 10 10 10 10 10 10 10 10 10 10 10 10 10 10 10 10 10 10 10 10 10
10 10 10 10 10 10 10 10 10 10 10 10 10 10 10 10 10 10 10 10 10 10 10 10 10 10 10 10
10 10 10 10 10 10 10 10 10 10 10 10 10 10 10 10 10 10 10 10 10 10 10 10 10 10 10 10
10 10 10 10 10 10 10 10 10 10 10 10 10 10 10 10 10 10 10 10 10 10 10 10 10 10 10 10
10 10 10 10 10 10 10 10 10 10 10 10 10 10 10 10 10 10 10 10 10 10 10 10 10 10 10 10
10 10 10 10 10 10 10 10 10 10 10 10 10 10 10 10 10 10 10 10 10 10 10 10 10 10 10 10
10 10 10 10 10 10 10 10 10 10 10 10 10 10 10 10 10 10 10 10 10 10 10 10 10 10 10 10
21 10 10 10 10 10 10 10 10 10 10 10 10 10 10 10 10 10 10 10 10 10 10 10 10 10 10 10
21 10 10 10 10 10 10 10 10 10 10 10 10 10 10 10 10 10 10 10 10 10 10 10 10 10 10 10
21 10 10 10 10 10 10 10 10 10 13 13 13 13 13 13 21 10 10 10 10 10 10 10 10 10 10 10
21 10 10 10 10 10 10 10 10 10 13 13 13 13 13 13 21 10 10 10 10 10 10 10 10 10 10 10
21 10 10 10 10 10 10 10 10 10 13 13 13 13 13 13 21 10 10 10 10 10 10 10 10 10 10 10
21 10 10 10 10 10 10 10 10 10 13 13 13 13 13 13 20 10 10 10 10 10 10 10 10 10 10 10
21 13 13 13 13 13 13 13 13 13 13 13 13 13 13 13 13 10 10 10 10 10 10 10 10 10 10 10
21 13 13 13 13 13 13 13 13 13 13 13 13 13 13 13 21 10 10 10 10 10 10 10 10 10 10 10
21 13 13 13 13 13 13 13 13 13 13 13 13 13 13 13 21 10 10 10 10 10 10 10 10 10 10 10
21 13 13 24 21 21 22 21 21 23 13 13 13 13 13 13 21 10 10 10 10 10 10 10 10 10 10 10
21 13 13 19 17 17 17 17 17 18 13 13 13 13 13 13 21 21 21 21 21 21 21 21 21 21 21 21
21 13 13 19 17 17 17 17 17 18 13 13 13 13 13 13 21 20 20 20 20 20 20 20 20 20 20 21
21 13 13 19 17 17 17 17 17 18 13 13 13 13 13 13 21 20 20 20 20 20 20 20 20 20 20 21
21 13 13 19 17 17 17 17 17 18 13 13 13 13 13 13 21 13 13 13 13 13 13 13 13 13 13 21
21 13 13 19 17 17 17 17 17 18 13 13 13 13 13 13 20 13 13 13 13 13 13 13 13 13 13 21
21 13 13 19 17 17 17 17 17 18 13 13 13 13 13 13 13 13 13 13 13 13 13 13 13 13 13 21
21 13 13 19 17 17 17 17 17 18 13 13 13 13 13 13 21 13 13 13 13 13 21 13 13 13 13 21
21 13 13 19 17 17 17 17 17 18 13 13 13 13 13 13 21 13 13 13 13 13 21 13 13 13 13 21
21 13 13 19 17 17 17 17 17 18 13 13 13 13 13 13 21 13 13 13 13 13 21 13 13 13 13 21
21 13 13 19 17 17 17 17 17 18 13 13 13 13 13 13 21 13 13 13 13 13 21 13 13 13 13 21
21 21 21 21 21 21 21 21 21 21 21 21 21 21 21 21 21 21 21 21 21 21 21 21 21 21 21 21
