2 0 0 2 2 2 2 2 2 2 2 4 4 2 2 2
2 0 0 0 0 0 0 0 0 0 0 4 4 0 0 2
2 5 5 5 5 5 5 5 5 5 5 4 4 0 0 2
2 0 0 0 0 0 0 0 0 0 0 4 4 0 0 2
2 0 0 0 0 0 0 0 0 0 0 4 4 0 0 2
2 0 0 0 0 0 0 0 0 0 0 4 4 0 0 2
2 0 0 0 0 0 0 0 0 0 0 4 4 0 0 2
2 0 0 0 0 0 0 0 0 0 0 4 4 0 0 2
2 0 0 0 0 0 0 0 0 0 0 4 4 0 0 2
2 0 0 0 0 3 0 0 0 0 0 4 4 1 0 2
2 0 0 0 0 0 0 0 0 0 0 4 4 0 0 2
2 2 2 2 2 2 2 2 2 2 2 4 4 2 2 2
